....................
.---e----------e---.
.-------wBw--------.
.wwwwwwww-wwwwwwwww.
.------------------.
.--wwwww-E-wwwww---.
.--w-----------w---.
.--w-----S-----w---.
.--w-----------w---.
.------------------.
.------------------.
.--w-----B-----w---.
.--w-----------w---.
.--wwwww---wwwww---.
.------------------.
.-----w-----w------.
.-E---w-----w---E--.
.-----w-----w------.
.-----w--P--w------.
....................