....................
.P-------w---------.
.------e-w---------.
.--------w---------.
.----wwwww---------.
.------------------.
.------------------.
.------------------.
.------------------.
.------------------.
.------------------.
.-----------e------.
.------------------.
.------------------.
.------------------.
.------------------.
.------------------.
.------------------.
.------------------.
....................