....................
.P--------w---w----.
.------e--w-w-wwww-.
.---------w-w------.
.----wwwwww-wwwwww-.
.------------------.
.-wwwwwwwww-wwww---.
.--------------w---.
.-----w--------w---.
.-----w---B----w---.
.-----w--------w---.
.-----wwwwwwwwww---.
.------------------.
.-----wwwwwwwww----.
.--------w---------.
.--------w-wwww----.
.--------w----w----.
.--------wwwwww----.
.------------------.
....................