....................
.P-------w---------.
.------E-w---------.
.--------w---------.
.----wwwww---------.
.------------------.
.------------------.
.------------------.
.------------------.
.------------------.
.------------------.
.-----------E------.
.------------------.
.------------------.
.------------------.
.------------------.
.------------------.
.------------------.
.------------------.
....................